XXXXXXXXXXXXXXXXXXXXXXXXXXXXXXXXXXXXXXXXXXXXXX
X____________________X___________X___________X
X__X__X__XXXXXXXXX___X___XXX__X__XXXXXXXXX___X
X__X__X__X___________X_____X__X______________X
X__X__XXXXXXXXXXXXXXXX__XXXX__XXXXXXXXXXXXXXXX
X__X__X______________X__X__X_________________X
X__X__X__XXXXXXXXXX__X__X__XXXXXXXXXXXXXXXX__X
X__X__X__X_______FX_____X_____X___________X__X
X__X__X__X__XXXXXXXXXXXXX___XXX___XXXXXX__X__X
X__X__X__X__X__________________________X__X__X
XXXX__X__X__X__XXXXXXXXXXXXXXXXXXXXXXXXX__X__X
X_____X__X__X__X__X_____X_________________X__X
XXX___X__X__X__X__X__X__X__XXX___XXXXXXXXXX__X
X_____X__X__X__X_____X__X__X_____X___________X
X__X__X__X__X__XXXXXXX__X__XXXX__X__XXXXXXX__X
X__X__X__X__X___________X__X__X__X__X_____X__X
X__XXXX__X__XXXXXXXXXX__X__X__X__X__X__X__X__X
X__X_____X___________X__X__X__X__X__X__X_____X
X__X__XXXXXXXXXXXXX__X__X__X__X__X__XXXXXXXXXX
X__X__X___________X__X__X__X__X__X___________X
X__X__X__XXXXXX___X__X__X__X__X__XXXXXXXXXX__X
X__X__X__X___________X__X__X__X__X________X__X
X__X__X__XXXXXXXXXXXXX__X__X__X__X__X__XXXX__X
X_____X_________________X__X__X__X__X__X_____X
XXXX__X__XXXXXXXXXXXXXXXX__X__X__XXXX__X__X__X
X__X__X__X__X______________X___________X__X__X
X__X__X__X__X__XXXX__XXXXXXXXXXXXXXXXXXX__XXXX
X_____X_____X__X__X__X_________________X_____X
X___XXXXXXXXX__X__X__X__XXXXXX___XXX___XXX___X
X______________X_____X__X________X___________X
XXXXXXXXXXXXXXXXXXXXXXS_XXXXXXXXXXXXXXXXXXXXXX
