_______________________________________________________________________
____XX____XX____XX____XX____XX____XX____XX____XX____XX____XX____XX_____
__S__X_____X_____X_____X_____X_____X_____X_____X_____X_____X_____X_____
____XX_XX_XX_XX_XX_XX_XX_XX_XX_XX_XX_XX_XX_XX_XX_XX_XX_XX_XX_XX_XX_XX_F
________X_____X_____X_____X_____X_____X_____X_____X_____X_____X_____X__
_______XX____XX____XX____XX____XX____XX____XX____XX____XX____XX____XX__
_______________________________________________________________________
