__________________________________________________
_____________XXXXXX______________XXXXXXXXXXXXXXXX_
__________________X_____________X_________________
__________________X__XXXXX_____X___XXXXXXXXXXXXXXX
______X______XXXXXX______X____X___________________
_____SX__________________X___X__X______X__________
____XXX______________XXXXX__X___X______X__________
______X____________________X____X______X__________
______X__XXXXX____________X_____X______X__________
_XXXXXX______X___________X______XXXXXXXX__________
______X______X__________X__________________X______
XXXXX_X______X_________X______________X____X______
______X______X________X_______________XXXXXX______
______X______X_______X____________________________
______X______X________X____________________XXX____
______X______X_________X___________________XF_____
______X______X__________X__________________XXX____
______X______X___________X________________________
______X______X____________X_______________________
______X______X_____________X______________________
_____________X____________________________________
