XXXXXXXXXXXXXXXXXXXXXXXXXXXXXXXXXXX
X_X_X_X_X_X_X_________X_X_XXXXXXXXX
X_X_X_X_X_X_X___X_X_X_X_X_XXXXXXXXX
X_______________X_X_X____________FX
X_X_X_X___X_X___X_X_XXX_X_XXXXXXXXX
X_X_X_X___X_X_________X_X_XXXXXXXXX
X_X_X_X___X_X_________X_X_XXXXXXXXX
X_X_X_X___X_X_X_X_X_X_X_X_XXXXXXXXX
X_X_X_X_____X_X_X_X_X_X_X_XXXXXXXXX
X_X_X_X_X___X_X_X_X_XXXXXXXXXXXXXXX
X_X_X_X_X___X_X_X_XXXXXXXXXXXXXXXXX
X_X_X_X_____X_X_XXXXXXXXXXXXXXXXXXX
X_X_X_X___X_X_XXXXXXXXXXXXXXXXXXXXX
X_X_______X_XXXXXXXXXXXXXXXXXXXXXXX
X_X___X_X_XXXXXXXXXXXXXXXXXXXXXXXXX
X_X___X_XXXXXXXXXXXXXXXXXXXXXXXXXXX
X_____XXXXXXXXXXXXXXXXXXXXXXXXXXXXX
X_X_XXXXXXXXXXXXXXXXXXXXXXXXXXXXXXX
X_SXXXXXXXXXXXXXXXXXXXXXXXXXXXXXXXX
XXXXXXXXXXXXXXXXXXXXXXXXXXXXXXXXXXX
