_____X________________________________________________________X___X___X___X___X___X____________________________________________X
___X__X______________________XXXXXXXXX______________________X_X_X_X_X_X_X_X_X_X_X_X_X_____X_____X_____X_____X_____X_____X_____X_
__SX___X_____________________________X______________________X_X_X_X_X_X_X_X_X_X_X_X_X____X_X___X_X___X_X___X_X___X_X___X_X___X__
_XXX____X__________________________X_X____________________X_X_X_X_X_X___X___X___X___X___X___X_X___X_X___X_X___X_X___X_X___X_X___
_________X_____XXXXX____X__________X_X___________________X__X_X_X_X_XXXXXXXXXXXXXXXXXXXX_____X__X__X__X_X_X_X__X_____X_____X____
__________X________X____X__XXXXXXXXX_X___XXXXXX_________X___X_X_X_X__________________X_________X______X_____X___________________
___________X_______X____X________X__________X__________X____X___X_X_X___X___X___X___XX__________X____XX_____X_______X___________
___________________X____X________X_X________X_XXXXXXX_X___XXXXXXX_X___X___X___X___X__X___________XXXX__XXXXX_XXXXXXXX___________
___________________X____X__________X__________X_______X___________X_X___X___X___X___XX__________________________________________
___XXXXXXXXXXXXXXXXX____XXXXXXXXXXXXXXXXXXXXXXX_XXXXXXX___________X___X___X___X___X__X_X_X_X_X_X_X_X_X_X_X_X_X_X_X_X_X_X_X_X_X_X
________________________________________X___X___X________________X__X___X___X___X___XX__________________________________________
________________________________________X_X_X_X_X_X______________X____X___X___X___X__XX_X_X_X_X_X_X_X_X_X_X_X_X_X_X_X_X_X_X_X_X_
________________________________________X_X_X_X_X_X______XXX____X___X___X___X___X___XX__________________________________________
XXXXXXXXXXXXXXXXXXXXX_X_________________X_X_X_X_X_X_____X_______X_____X___X___X___X__X_X_X_X_X_X_X_X_X_X_X_X_X_X_X_X_X_X_X_X_X_X
_______________________X__________________X___X___X_____X_______X___X___X___X___X___XX__________________________________________
_XXXXXXXXXXXXXXXXXXXXXXXXXXXXXXXXXXXXXXXXXXXXXXXXXX______XX____X______X___X___X___X__XX_X_X_X_X_X_X_X_X_X_X_X_X_X_X_X_X_X_X_X_X_
__X________________________________________________________XXXX_____X___X___X___X___XX__________________________________________
X__X___X___________________XX_________________________________________X___X___X___X__X_X______________________________________X_
_X__X__XXX_X_____________XX_____X___X___X___X___X___X___X___X___X___X___X___X___X___XX__X____________________________________X__
__X____X____XX_________XX_____X___X___X___X___X___X___X___X___X___X___X___X___X___X__X___X__________________________________X___
_______X______XX_____XX_____X___X___X___X___X___X___X___X___X___X___X___X___X___X___XX____X________________________________X____
_X_____X_X______XXXXX_____X___X___X___X___X___X___X___X___X___X___X___X___X___X___X__X_____X______________________________X_____
_XXXXXXX__X_XX__X____________________________________________________________________X______X____________________________X______
_______X___X____X_________XXXXXXXXXXXXXXXXXXXXXXXXXXXXXXXXXXXXXXXXXXXXXXXXXXXXXXXXXXXX_______X__________________________X_______
XXXXXX_X______XXXX________X___________________________________________________________________X________________________X________
_______X__________X________X___________________________________________________________________X______________________X_________
_XXXXXXX___________X________X___________________________________________________________________X____________________X__________
___________X__XXXX___________X___________________________________________________________________X__________________X___________
X___________XX________________X___________________________________________________________________X________________X____________
_X____________X__X_X__________X____________________________________________________________________X______________X_____________
__X___________X__XXX__________X_____________________________________________________________________X____________X______________
___XX________X_______X_X______X______________________________________________________________________X__________X_______________
_____XXX____X__X__X_X___X____X________________________________________________________________________X________X________________
_____X__XXXX___XXXX_____X___X__________________________________________________________________________X______X_________________
______X_______X____X___X___X____________________________________________________________________________X____X__________________
_______XX____X______XXX___X______________________________________________________________________________X__X___________________
_________XXXX___________XX________________________________________X_______________________________________X_X_XXXXXXXXXXXXXXXXXX
_____________________XXX___________________________________________X______________________________________X_X___________________
_________________XXXX_______________________________________________X_____________________________________X_XXXXXXXXXXXXXXXXXXX_
____________XXXXX____________________________________________________X____________________________________X_X___________________
______XXXXXX__________________________________________________________X___________________________________X_X_XXXXXXXXXXXXXXXXXX
_XXXXX_________________________________________________________________X__________________________________X_X___________________
________________________________________________________________________X_________________________________X_XXXXXXXXXXXXXXXXXXX_
_________________________________________________________________________X________________________________X_X___________________
__________________________________________________________________________X_______________________________X_X_XXXXXXXXXXXXXXXXXX
___________________________________________________________________________X______________________________X_X___________________
____________________________________________________________________________X_____________________________X_XXXXXXXXXXXXXXXXXXX_
_____________________________________________________________________________X____________________________X_X___________________
______________________________________________________________________________X___________________________X_X_XXXXXXXXXXXXXXXXXX
_______________________________________________________________________________X__________________________X_X___________________
XX______________________________________________________________________________X_________________________X_XXXXXXXXXXXXXXXXXXX_
__XXX____________________________________________________________________________X________________________X_X___________________
_____XXX__________________________________________________________________________X_______________________X_X_XXXXXXXXXXXXXXXXXX
________XXX________________________________________________________________________X______________________X_X___________________
___________XXX______________________________________________________________________X_____________________X_XXXXXXXXXXXXXXXXXXX_
______________XXX______________________________________________________________XXX___X____________________X_X___________________
_________________XXX________________________________________________________XXX___________________________X_X_XXXXXXXXXXXXXXXXXX
____________________XXX__________________________________________________XXX____________________XXXX______X_X___________________
_______________________XXX____________________________________________XXX___________________XXXX__________X_XXXXXXXXXXXXXXXXXXX_
__________________________XXX______________________________________XXX__________________XXXX______________X_X___________________
_____________________________XXX________________________________XXX_________________XXXX__________________X_X_XXXXXXXXXXXXXXXXXX
________________________________XXX__________________________XXX________________XXXX______________________X_X___________________
___________________________________XXX____________________XXX_____________________________________________X_XXXXXXXXXXXXXXXXXXX_
______________________________________XXX______________XXX________________________________________________X_X___________________
____________________________________________________XXX___________________________________________________X_X_XXXXXXXXXXXXXXXXXX
_________________________________________________XXX______________________________________________________X_X___________________
______________________________________________XXX__________________X______________________________________X_XXXXXXXXXXXXXXXXXXX_
___________________________________________XXX______________________X_____________________________________X_X___________________
________________________________________XXX__________________________X____________________________________X_X_XXXXXXXXXXXXXXXXXX
_____________________________________XXX______________________________X___________________________________X_X___________________
__________________________________XXX__________________________________X__________________________________X_XXXXXXXXXXXXXXXXXXX_
________________________________________________________________________X_________________________________X_X___________________
_________________________________________________________________________X________________________________X_X_XXXXXXXXXXXXXXXXXX
__________________________________________________________________________X_______________________________X_X___________________
___________________________________________________________________________X______________________________X_XXXXXXXXXXXXXXXXXXX_
____________________________________________________________________________X_____________________________X_X___________________
_____________________________________________________________________________X____________________________X_X_XXXXXXXXXXXXXXXXXX
______________________________________________________________________________X___________________________X_X___________________
_______________________________________________________________________________X__________________________X_XXXXXXXXXXXXXXXXXXX_
________________________________________________________________________________X_________________________X_X___________________
_________________________________________________________________________________X________________________X_X_XXXXXXXXXXXXXXXXXX
__________________________________________________________________________________X_______________________X_X___________________
___________________________________________________________________________________X______________________X_X___________________
____________________________________________________________________________________X_____________________X_X___________________
_____________________________________________________________________________________X____________________X_X___________________
______________________________________________________________________________________X___________________X_X___________________
_______________________________________________________________________________________X__________________X_X___________________
________________________________________________________________________________________X_________________X_X___________________
_________________________________________________________________________________________X________________X_X___________________
________________________________________________________________________________X_________X_______________X_X___________________
_______________________________________________________________________________X___________X______________X_X___________________
______________________________________________________________________________X_____________X_____________X_X___________________
_____________________________________________________________________________X_______________X____________X_X___________________
____________________________________________________________________________X_________________X___________X_X___________________
___________________________________________________________________________X_________________________XXXXXX_X___________________
__________________________________________________________________________X______________________XXXX_____X_X___________________
_________________________________________________________________________X____________________XXX_________X_X___________________
________________________________________________________________________X___________________XX____________X_X___________________
_______________________________________________________________________X___________________X______________X_X___________________
______________________________________________________________________X___________________X_______________X_X___________________
_____________________________________________________________________X____________________X_______________X_X___________________
____________________________________________________________________X____________________X________________X_X___________________
___________________________________________________________________X_____________________X_______XXXXXXXXXX_X___________________
__________________________________________________________________X______________________X__________________XXXXXXXXXXXXXXXXXXX_
_________________________________________________________________X________________________X_________________X__X___X___X________
________________________________________________________________X_________________________X________________X___X_X_X_X_X_X_X____
_______________________________________________________________X___________________________X______________XX_X_X_X_X_X_X_X_X____
______________________________________________________________X_____________________________XX__________XX_X_X_X_X_X_X_X_X_X____
_____________________________________________________________X________________________________XXX____XXX___X_X_X_X_X_X_X_X_X____
____________________________________________________________X____________________________________XXXX__X_X_X_X_X_X_X_X_X_X_X____
___________________________________________________________X_______________________________________X___X_X_X_X_X_X_X_X_X_X_X____
__________________________________________________________X______________________________________X_X_X_X_X_X_X_X_X_X_X_X_X_X____
_________________________________________________________X_______________________________________X___X___X___X___X___X___X_X____
________________________________________________________X________________________________________XXXXXXXXXXXXXXXXXXXXXXXXX_X____
_______________________________________________________X_________________________________________X_______________X_________X____
______________________________________________________X__________________________________________X_X_____________X_XXXXXXX_X____
_____________________________________________________X___________________________________________X_X_____________X_X_____X_X____
____________________________________________________X____________________________________________X_X_____________X_X_XXX_X_X____
___________________________________________________X_______________________________________________X_____________X___XF__X_X____
_________________________________________________________________________________________________X_X_____________X_X_X___X_X____
_________________________________________________________________________________________________X_X_____________X_X_____X_X____
_________________________________________________________________________________________________X_X_____________X_XXXXXXX_X____
_________________________________________________________________________________________________X_______________X_________X____
_________________________________________________________________________________________________XXXXXXXXXXXXXXXXXXXXXXXXXXX____
________________________________________________________________________________________________________________________________
________________________________________________________________________________________________________________________________
________________________________________________________________________________________________________________________________
________________________________________________________________________________________________________________________________
