________________________________
__X_____________________________
__X_____________________________
__X_____________________________
__X_____________________________
__X_____________________________
__X_____________________________
__X_____________________________
__X_____________________________
__X_____________________________
__X_____________________________
__X_____________________________
S_XXXXXXXXXXXXXXXXXXXXXXXXXXXXXF
__X___X___X___X___X___X___X___X_
__X_X_X_X_X_X_X_X_X_X_X_X_X_X_X_
__X_X_X_X_X_X_X_X_X_X_X_X_X_X_X_
__X_X_X_X_X_X_X_X_X_X_X_X_X_X_X_
__X_X_X_X_X_X_X_X_X_X_X_X_X_X_X_
__X_X_X_X_X_X_X_X_X_X_X_X_X_X_X_
__X_X_X_X_X_X_X_X_X_X_X_X_X_X_X_
__X_X_X_X_X_X_X_X_X_X_X_X_X_X_X_
__X_X_X_X_X_X_X_X_X_X_X_X_X_X_X_
____X___X___X___X___X___X___X___
